#########
###B ####
###     #
### ### #
#A  ### #
#       #
#########